アーグスコメット	タナバタウオ科
アークフィンシュリンプゴビー	ハゼ科
アイゴ	アイゴ科
アイスズメダイ	スズメダイ科
アイナメ	アイナメ科
アウターリーフダムゼル	スズメダイ科
アオイソハゼ	ハゼ科
アオギハゼ	ハゼ科
アオサハギ	カワハギ科
アオスジエビス	イットウダイ科
アオスジテンジクダイ	テンジクダイ科
アオスジハタ	ハタ科
アオタテジマチョウチョウウオ	チョウチョウウオ科
アオチビキ	フエダイ科
アオノメハタ	ハタ科
アオバスズメダイ	スズメダイ科
アオハチハゼ	ハゼ科
アオヒゲシノビハゼ	ハゼ科
アオブダイ	ブダイ科
アオマスク	キツネアマダイ科
アオヤガラ	ヤガラ科
アカエイ	アカエイ科
アカエソ	エソ科
アカオビハナダイ	ハタ科
アカオビベラ	ベラ科
アカククリ	マンジュウダイ科
アカササノハベラ	ベラ科
アカシュモクザメ	シュモクザメ科
アカスジウミタケハゼ	ハゼ科
アカタチ	アカタチ科
アカツキハギ	ニザダイ科
アカテンモチノウオ	ベラ科
アカニジベラ	ベラ科
アカネキンチャクダイ	キンチャクダイ科
アカネダルマハゼ	ハゼ科
アカネハナゴイ	ハタ科
アカハタ	ハタ科
アカハチハゼ	ハゼ科
アカハナ	ハタ科
アカハラヤッコ	キンチャクダイ科
アカヒメジ	ヒメジ科
アカホシキンセンイシモチ	テンジクダイ科
アカホシハタ	ハタ科
アカボシハナゴイ	ハタ科
アカマダラハタ	ハタ科
アカマツカサ	イットウダイ科
アカメハゼ	ハゼ科
アカメバル	メバル科
アカメモドキ	アカメ科
アカモンガラ	モンガラカワハギ科
アクシルスポットラス	ベラ科
アケボノチョウチョウウオ	チョウチョウウオ科
アケボノハゼ	クロユリハゼ科
アゴハタ	ハタ科
アサドスズメダイ	スズメダイ科
アザハタ	ハタ科
アサヒアナハゼ	カジカ科
アザミカワハギ	カワハギ科
アジアコショウダイ	イサキ科
アズキハタ	ハタ科
アセウツボ	ウツボ科
アツクチスズメダイ	スズメダイ科
アデヤッコ	キンチャクダイ科
アドーンドラス	ベラ科
アドニスシュリンプゴビー	ハゼ科
アトヒキテンジクダイダマシ	テンジクダイ科
アブラヤッコ	キンチャクダイ科
アフリカンコリス	ベラ科
アマクチビ	フエフキダイ科
アマダレドクハタ	ハタ科
アマノガワテンジクダイ	テンジクダイ科
アマミスズメダイ	スズメダイ科
アミアイゴ	アイゴ科
アミチョウチョウウオ	チョウチョウウオ科
アミトリキュウセン	ベラ科
アミメウマズラハギ	カワハギ科
アミメオトメエイ	アカエイ科
アミメチョウチョウウオ	チョウチョウウオ科
アミメトビエイ	トビエイ科
アミメハギ	カワハギ科
アミメフエダイ	フエダイ科
アミメブダイ	ブダイ科
アミモンガラ	モンガラカワハギ科
アヤコショウダイ	イサキ科
アヤメエビス	イットウダイ科
アヤメヤッコ	キンチャクダイ科
アラフラオオセ	オオセ科
アラレキンチャクフグ	フグ科
アルファスズメダイ	スズメダイ科
アレンズカーディナルフィッシュ	テンジクダイ科
アレンズラス	ベラ科
アローブレニー	コケギンポ科
アワユキハナカエルウオ	イソギンポ科
アンダマンウバウオ	ウバウオ科
アンダマンジョーフィッシュ	アゴアマダイ科
アンダマンスイートリップス	イサキ科
アンダマンダムゼル	スズメダイ科
アンダマンドティーバック	メギス科
アンダマントリプルフィン	ヘビギンポ科
アンダマンバタフライフィッシュ	チョウチョウウオ科
アンダマンフォックスフェイス	アイゴ科
アンボンスズメダイ	スズメダイ科
イースタンウィラー	ハタ科
イースタンフィドラーレイ	サカタザメ科
イースタンフラフィッシュ	タナバタウオ科
イースタンブルーグローパー	ベラ科
イースタンポムフレッド	ヒメツバメウオ科
イエローアイドコムトゥース	イソギンポ科
イエローカーディナルフィッシュ	テンジクダイ科
イエロージャック	アジ科
イエロースティングレイ	ウロトリゴン科
イエローストライプドカーディナルフィッシュ	テンジクダイ科
イエローストライプモノクルブリーム	イトヨリダイ科
イエロースナッパー	フエダイ科
イエロースポットプラー	スズメダイ科
イエローテールサージョンフィッシュ	ニザダイ科
イエローテールダッシラス	スズメダイ科
イエローテールダムセルフィッシュ	スズメダイ科
イエローテールチューブリップ	ベラ科
イエローテイルスナッパー	フエダイ科
イエローデビルフィッシュ	タナバタウオ科
イエロードティーバック	メギス科
イエロードワーフゴビー	ハゼ科
イエローバックフュージラー	タカサゴ科
イエローフィンパロットフィッシュ	ブダイ科
イエローフィンフラッシャーラス	ベラ科
イエローフィンモジャラ	クロサギ科
イエローヘッドジョーフィッシュ	アゴアマダイ科
イエローヘッドドワーフゴビー	ハゼ科
イエローヘッドバタフライフィッシュ	チョウチョウウオ科
イエローヘッドラス	ベラ科
イエローモレイ	ウツボ科
イエローラインドカーディナルフィッシュ	テンジクダイ科
イケカツオ	アジ科
イサキ	イサキ科
イシガキカエルウオ	イソギンポ科
イシガキスズメダイ	スズメダイ科
イシガキダイ	イシダイ科
イシダイ	イシダイ科
イシフエダイ	フエダイ科
イシヨウジ	ヨウジウオ科
イスズミ	イスズミ科
イズヒメエイ	アカエイ科
イソゴンベ	ゴンベ科
イソスズメダイ	スズメダイ科
イソフエフキ	フエフキダイ科
イソマグロ	サバ科
イソモンガラ	モンガラカワハギ科
イタチウオ	アシロ科
イチモンジコバンハゼ	ハゼ科
イチモンジハゼ	ハゼ科
イチモンジブダイ	ブダイ科
イチモンスズメダイ	スズメダイ科
イッセンタカサゴ	タカサゴ科
イッテンチョウチョウウオ	チョウチョウウオ科
イッテンフエダイ	フエダイ科
イットウダイ	イットウダイ科
イッポンテグリ	ネズッポ科
イトヒキアジ	アジ科
イトヒキサギ	クロサギ科
イトヒキテンジクダイ	テンジクダイ科
イトヒキフエダイ	フエダイ科
イトヒキブダイ	ブダイ科
イトヒキベラ	ベラ科
イトフエフキ	フエフキダイ科
イトマンクロユリハゼ	クロユリハゼ科
イナズマタテガミカエルウオ	イソギンポ科
イナズマヒカリイシモチ	テンジクダイ科
イナズマベラ	ベラ科
イナズマヤッコ	キンチャクダイ科
イナセギンポ	イソギンポ科
イバラエイ	アカエイ科
イバラタツ	ヨウジウオ科
イマキュレイトゴビー	ハゼ科
イマキュレットダムゼル	スズメダイ科
イモトフエダイ	フエダイ科
イレズミゴンベ	ゴンベ科
イレズミサルハゼ	ハゼ科
イレズミニザ	ニザダイ科
イレズミハゼsp	ハゼ科
イレズミフエダイ	フエダイ科
イロカエルアンコウ	カエルアンコウ科
イロブダイ	ブダイ科
イワサキスズメダイ	スズメダイ科
インコハゼ	ハゼ科
インディアンオーシャンピンストライプドラス	ベラ科
インディアンゴールドリングブリストルトゥース	ニザダイ科
インディアンセイルフィンサージョンフィッシュ	ニザダイ科
インディアンダッシラス	スズメダイ科
インディアンダムゼル	スズメダイ科
インディアンティアドロップバタフライフィッシュ	チョウチョウウオ科
インディアントリガーフィッシュ	モンガラカワハギ科
インディアンバカボンドバタフライフィッシュ	チョウチョウウオ科
インディアンバタフライフィッシュ	チョウチョウウオ科
インディアンバナーフィッシュ	チョウチョウウオ科
インディアンミミックサージョンフィッシュ	ニザダイ科
インディアンライアテールバスレット	ハタ科
インディアンライオンフィッシュ	フサカサゴ科
インディゴハムレット	ハタ科
インドオキアジ	アジ科
インドカイワリ	アジ科
インドカエルウオ	イソギンポ科
インドヒメジ	ヒメジ科
インポスターファングブレニー	イソギンポ科
ウーンデッドラス	ベラ科
ウイゴンベ	ゴンベ科
ウィップフィンラス	ベラ科
ウェイビーラインドグルーパー	ハタ科
ウエッジスポットダムゼル	スズメダイ科
ウケグチイットウダイ	イットウダイ科
ウサギニベ	ニベ科
ウシエイ	アカエイ科
ウシオニハゼ	ハゼ科
ウスジマイシモチ	テンジクダイ科
ウスモモテンジクダイ	テンジクダイ科
ウツボ	ウツボ科
ウマヅラアジ	アジ科
ウマヅラハギ	カワハギ科
ウミショウブハゼsp	ハゼ科
ウミスズメ	ハコフグ科
ウミタナゴ	ウミタナゴ科
ウミヅキチョウチョウウオ	チョウチョウウオ科
ウミテング	ウミテング科
ウメイロ	フエダイ科
ウメイロモドキ	タカサゴ科
ウルマカエルアンコウ	カエルアンコウ科
ウロコマツカサ	イットウダイ科
エイブルズエンゼルフィッシュ	キンチャクダイ科
エクスクイジットバタフライフィッシュ	チョウチョウウオ科
エクリプスパロットフィッシュ	ブダイ科
エスチュアリーコブラー	ゴンズイ科
エバンズアンティアス	ハタ科
エリグロギンポ	イソギンポ科
エレガントゴビー	ハゼ科
エレガントユニコーンフィッシュ	ニザダイ科
エワファングブレニー	イソギンポ科
エンマゴチ	コチ科
オーシャンサージョンフィッシュ	ニザダイ科
オーシャントリガーフィッシュ	モンガラカワハギ科
オーストラリアンカウノーズレイ	トビエイ科
オーストラリアンマド	イスズミ科
オーナメンテッドラス	ベラ科
オービキュラーダムゼル	スズメダイ科
オールドワイフ	エノプロスス科
オーロラシュリンプゴビー	ハゼ科
オイランヨウジ	ヨウジウオ科
オウギチョウチョウウオ	チョウチョウウオ科
オウゴンニジギンポ	イソギンポ科
オウムブダイ	ブダイ科
オオカマス	カマス科
オオクチイケカツオ	アジ科
オオスジイシモチ	テンジクダイ科
オオスジヒメジ	ヒメジ科
オオセ	オオセ科
オオテンジクザメ	コモリザメ科
オオテンハナゴイ	ハタ科
オオニベ	ニベ科
オオフエフキ	フエフキダイ科
オオフエヤッコダイ	チョウチョウウオ科
オオメカマス	カマス科
オオメジロザメ	メジロザメ科
オオメハゼ	ハゼ科
オオモンカエルアンコウ	カエルアンコウ科
オオモンハゲブダイ	ブダイ科
オオモンハゼ	ハゼ科
オオモンハタ	ハタ科
オカメブダイ	ブダイ科
オキゴンベ	ゴンベ科
オキザヨリ	ダツ科
オキナヒメジ	ヒメジ科
オキナワスズメダイ	スズメダイ科
オキナワノコギリウツボ	ウツボ科
オキナワベニハゼ	ハゼ科
オキフエダイ	フエダイ科
オグロオトメエイ	アカエイ科
オグロクロユリハゼ	クロユリハゼ科
オグロトラギス	トラギス科
オグロベラ	ベラ科
オグロメジロザメ	メジロザメ科
オジサン	ヒメジ科
オシャレコショウダイ	イサキ科
オジロエイ	アカエイ科
オジロスズメダイ	スズメダイ科
オジロトラギス	トラギス科
オジロバラハタ	ハタ科
オスジイソハゼ	ハゼ科
オスジクロハギ	ニザダイ科
オセレイトパイプフィッシュ	ヨウジウオ科
オトメハゼ	ハゼ科
オトメベラ	ベラ科
オドリハゼ	ハゼ科
オニアジ	アジ科
オニイトマキエイ	トビエイ科
オニカサゴ	フサカサゴ科
オニカマス	カマス科
オニサルハゼ	ハゼ科
オニダルマオコゼ	オニオコゼ科
オニツノハゼ	ハゼ科
オニテングハギ	ニザダイ科
オニハゲブダイ	ブダイ科
オニハゼ	ハゼ科
オニハゼsp	ハゼ科
オニハタタテダイ	チョウチョウウオ科
オニヒラアジ	アジ科
オニベラ	ベラ科
オニボラ	ボラ科
オハグロハギ	ニザダイ科
オハグロベラ	ベラ科
オバケインコハゼ	ハゼ科
オビアナハゼ	カジカ科
オビテンスモドキ	ベラ科
オビブダイ	ブダイ科
オブリークラインドドティーバック	メギス科
オボロイシヨウジ	ヨウジウオ科
オヤビッチャ	スズメダイ科
オヨギイソハゼ	ハゼ科
オヨギベニハゼ	ハゼ科
オリーブアンティアス	ハタ科
オリオンスズメダイ	スズメダイ科
オルネートレオパードラス	ベラ科
オレンジサイドトリガーフィッシュ	モンガラカワハギ科
オレンジスポッテッドファイルフィッシュ	カワハギ科
オレンジバックフェアリーラス	ベラ科
オレンジフィンアネモネフィッシュ	スズメダイ科
オレンジラス	ベラ科
ガードナーズバタフライフィッシュ	チョウチョウウオ科
ガードルドスケーリーフィン	スズメダイ科
カールレアンダムゼル	スズメダイ科
カエルアンコウ	カエルアンコウ科
カエルウオ	イソギンポ科
カガミチョウチョウウオ	チョウチョウウオ科
カクレクマノミ	スズメダイ科
カゴカキダイ	イスズミ科
カサゴ	フサカサゴ科
カザリキュウセン	ベラ科
カザリキンチャクフグ	フグ科
カザリスズメダイ	スズメダイ科
カザリハゼ	ハゼ科
カシワハナダイ	ハタ科
カスザメ	カスザメ科
カスミアジ	アジ科
カスミチョウチョウウオ	チョウチョウウオ科
カスミヤライイシモチ	テンジクダイ科
カスリイシモチ	テンジクダイ科
カスリハゼ	ハゼ科
カスリハタ	ハタ科
カスリフサカサゴ	フサカサゴ科
カタボシオオモンハゼ	ハゼ科
カットリボンラス	ベラ科
カッポレ	アジ科
カニハゼ	ハゼ科
カノコベラ	ベラ科
ガフトップスルポンパーノ	アジ科
カブラヤスズメダイ	スズメダイ科
カブラヤテンジクダイ	テンジクダイ科
カペラサンカクハゼ	ハゼ科
カマスサワラ	サバ科
カマストガリザメ	メジロザメ科
カマスベラ	ベラ科
カミソリウオ	カミソリウオ科
カミナリベラ	ベラ科
カメレオンラス	ベラ科
カメンタマガシラ	イトヨリダイ科
カモハラギンポ	イソギンポ科
カライワシ	カライワシ科
ガラスハゼ	ハゼ科
ガラパゴスガーデンイール	アナゴ科
ガラパゴスグラント	イサキ科
ガラパゴスザメ	メジロザメ科
ガラパゴスバットフィッシュ	アカグツ科
ガラパゴスリングテールダムセルフィッシュ	スズメダイ科
ガルフシグナルブレニー	コケギンポ科
カレハスズメダイ	スズメダイ科
カワハギ	カワハギ科
カワリブダイ	ブダイ科
カンデラモアパロットフィッシュ	ブダイ科
カンパチ	アジ科
カンムリニセスズメ	メギス科
カンムリブダイ	ブダイ科
カンムリベラ	ベラ科
カンモンハタ	ハタ科
カンランハギ	ニザダイ科
キイロサンゴハゼ	ハゼ科
キイロハギ	ニザダイ科
キジハタ	ハタ科
キスジキュウセン	ベラ科
キスジゲンロクダイ	チョウチョウウオ科
キセンアカヒメジ	ヒメジ科
キセンフエダイ	フエダイ科
キタマクラ	フグ科
ギチベラ	ベラ科
キツネアマダイ	キツネアマダイ科
キツネウオ	イトヨリダイ科
キツネフエフキ	フエフキダイ科
キツネブダイ	ブダイ科
キツネベラ	ベラ科
キツネメネジリンボウ	ハゼ科
キヌバリ	ハゼ科
キヌベラ	ベラ科
キハダマグロ	サバ科
キハッソク	ハタ科
キビナゴ	ニシン科
キビレハタ	ハタ科
キビレハタンポ	ハタンポ科
キビレブダイ	ブダイ科
キビレボウズハギ	ニザダイ科
キヘリキンチャクダイ	キンチャクダイ科
キヘリモンガラ	モンガラカワハギ科
キホシスズメダイ	スズメダイ科
キャンディーケインドワーフゴビー	ハゼ科
キュウセン	ベラ科
ギュンターズラス	ベラ科
キリンアナハゼ	カジカ科
キリンミノ	フサカサゴ科
ギンガハゼ	ハゼ科
ギンガメアジ	アジ科
キンギョハナダイ	ハタ科
キングエンジェルフィッシュ	キンチャクダイ科
キングドワーフゴビー	ハゼ科
キンセンイシモチ	テンジクダイ科
キンセンハゼ	ハゼ科
キンセンフエダイ	フエダイ科
キンチャクダイ	キンチャクダイ科
キンメモドキ	ハタンポ科
ギンユゴイ	ユゴイ科
キンリンサザナミハギ	ニザダイ科
グースラインズファングブレニー	イソギンポ科
クイーンエンジェルフィッシュ	キンチャクダイ科
クイーンコリス	ベラ科
クイーンパロットフィッシュ	ブダイ科
クエ	ハタ科
クギベラ	ベラ科
クサビベラ	ベラ科
クサフグ	フグ科
クサヤモロ	アジ科
クジメ	アイナメ科
クジャクスズメダイ	スズメダイ科
クジャクベラ	ベラ科
クダゴンベ	ゴンベ科
クチベニソメワケベラ	ベラ科
クチベニフエフキ	フエフキダイ科
クチボソボラ	ボラ科
クツワハゼ	ハゼ科
クビアカハゼ	ハゼ科
クベラスナッパー	フエダイ科
クマザサハナムロ	タカサゴ科
クマドリ	モンガラカワハギ科
クマドリカエルアンコウ	カエルアンコウ科
クマドリキュウセン	ベラ科
クマドリキンチャクフグ	フグ科
クマノミ	スズメダイ科
クモウツボ	ウツボ科
クモギンポ	イソギンポ科
クモハダオオセ	オオセ科
クラウンアネモネフィッシュ	スズメダイ科
クラウントビー	フグ科
クラウンパファー	フグ科
クラウンラス	ベラ科
クラカオスズメダイ	スズメダイ科
クラカケエビス	イットウダイ科
クラカケチョウチョウウオ	チョウチョウウオ科
クラカケモンガラ	モンガラカワハギ科
グラッシースイーパー	ハタンポ科
グラフィックタスクフィッシュ	ベラ科
グリーンジャック	アジ科
グリーンダムセルフィッシュ	スズメダイ科
グリーンバードマウスラス	ベラ科
グリーンモレイ	ウツボ科
グリーンレイザーフィッシュ	ベラ科
クリオーラス	ベラ科
クリスマスラス	ベラ科
クリムゾンバンデッドラス	ベラ科
グルクマ	サバ科
グレーエンジェルフィッシュ	キンチャクダイ科
グレーグラント	イサキ科
グレーターソープフィッシュ	ハタ科
グレートバリアリーフブレニー	イソギンポ科
グレーバックダムゼル	スズメダイ科
グレーユニコーンフィッシュ	ニザダイ科
グレイバーグラント	イサキ科
クレステッドモルウォン	タカノハダイ科
クレナイニセスズメ	メギス科
クロイトハゼ	ハゼ科
クロウシノシタ	ウシノシタ科
クロエリオオメワラスボ	オオメワラスボ科
クロオビアトヒキテンジクダイ	テンジクダイ科
クロオビスズメダイ	スズメダイ科
クロオビダイ	イサキ科
クロオビチョウチョウウオ	チョウチョウウオ科
クロオビマツカサ	イットウダイ科
クログチニザ	ニザダイ科
クロコショウダイ	イサキ科
クロサギ	クロサギ科
クロシテンヤッコ	キンチャクダイ科
クロスジイソハゼ	ハゼ科
クロスジギンポ	イソギンポ科
クロスジスカシテンジクダイ	テンジクダイ科
クロスジメギス	メギス科
クロスズメダイ	スズメダイ科
クロソラスズメダイ	スズメダイ科
クロダイ	タイ科
クロダルマハゼ	ハゼ科
クロトガリザメ	メジロザメ科
クロハギ	ニザダイ科
クロハコフグ	ハコフグ科
クロハタ	ハタ科
クロヒラアジ	アジ科
クロフチススキベラ	ベラ科
クロベラ	ベラ科
クロヘリイトヒキベラ	ベラ科
クロホシイシモチ	テンジクダイ科
クロホシハゼ	ハゼ科
クロホシフエダイ	フエダイ科
クロホシマンジュウダイ	クロホシマンジュウダイ科
クロメガネスズメダイ	スズメダイ科
クロメジナ	イスズミ科
クロメバル	メバル科
クロモンガラ	モンガラカワハギ科
クロモンツキ	ニザダイ科
クロユリハゼ	クロユリハゼ科
クロリボンスズメダイ	スズメダイ科
ケーブバス	ハタ科
ケーブピグミーゴビー	ハゼ科
ケサガケベラ	ベラ科
ケショウハゼ	ハゼ科
ケショウフグ	フグ科
ケショウモンガラ	モンガラカワハギ科
ケラマハナダイ	ハタ科
ケルプフィッシュ	キロネムス科
コーツラス	ベラ科
コーラルデモイセル	スズメダイ科
ゴールデンカウレイ	トビエイ科
ゴールデンストライプドバタフライフィッシュ	チョウチョウウオ科
ゴールデンテールモレイ	ウツボ科
ゴールデンバタフライフィッシュ	チョウチョウウオ科
ゴールデンラインドラビットフィッシュ	アイゴ科
ゴールドスペックスジョーフィッシュ	アゴアマダイ科
ゴールドスペックルドシュリンプゴビー	ハゼ科
ゴールドスポットゴビー	ハゼ科
ゴールドバーラス	ベラ科
ゴールドバックダムゼル	スズメダイ科
ゴールドベリーダムゼル	スズメダイ科
コウライトラギス	トラギス科
コウワンテグリ	ネズッポ科
コガシラベラ	ベラ科
コガネアジ	アジ科
コガネキュウセン	ベラ科
コガネシマアジ	アジ科
コガネスズメダイ	スズメダイ科
コガネチョウチョウウオ	チョウチョウウオ科
コガネヤッコ	キンチャクダイ科
コクテンカタギ	チョウチョウウオ科
コクテンサザナミハギ	ニザダイ科
コクテンハギ	カワハギ科
コクテンフグ	フグ科
コクハンアラ	ハタ科
コクハンハタ	ハタ科
ココアダムセルフィッシュ	スズメダイ科
ゴシキイトヒキベラ	ベラ科
コシナガイスズミ	イスズミ科
コスジイシモチ	テンジクダイ科
コットンウィックグラント	イサキ科
コットンマウスジャック	アジ科
コトヒキ	シマイサキ科
コニー	ハタ科
コバンアジ	アジ科
コバンザメ	コバンザメ科
コバンヒメジ	ヒメジ科
コビトスズメダイ	スズメダイ科
コブダイ	ベラ科
ゴマアイゴ	アイゴ科
ゴマウツボ	ウツボ科
ゴマサバ	サバ科
ゴマチョウチョウウオ	チョウチョウウオ科
ゴマニザ	ニザダイ科
ゴマハギ	ニザダイ科
ゴマヒレキントキ	キントキダイ科
ゴマフエダイ	フエダイ科
ゴマフキンチャクフグ	フグ科
ゴマモンガラ	モンガラカワハギ科
コモドカーディナルフィッシュ	テンジクダイ科
コモリザメ	コモリザメ科
コモンシルバーベリー	クロサギ科
コモンスティングレイ	ヒラタエイ科
コモンフグ	フグ科
コラーレバタフライフィッシュ	チョウチョウウオ科
コルテスエンジェルフィッシュ	キンチャクダイ科
コルテスガーデンイール	アナゴ科
コルテスダムセルフィッシュ	スズメダイ科
コルテスレインボーラス	ベラ科
コロダイ	イサキ科
コンゴウテンジクダイ	テンジクダイ科
コンゴウフグ	ハコフグ科
ゴンズイ	ゴンズイ科
コンビクトブレニー	ポリディクテュス科
サーガッサムトリガーフィッシュ	モンガラカワハギ科
サージェントメジャー	スズメダイ科
サーベルトゥースブレニー	イソギンポ科
サウスアメリカンキャットフィッシュ	ヘプタプテルス科
サウスシーズデビル	スズメダイ科
サオトメハゼ	ハゼ科
サカタザメ	サカタザメ科
サクラダイ	ハタ科
サクラテンジクダイ	テンジクダイ科
ササスズメダイ	スズメダイ科
サザナミウシノシタ	ササウシノシタ科
サザナミトサカハギ	ニザダイ科
サザナミハギ	ニザダイ科
サザナミハゼ	ハゼ科
サザナミフグ	フグ科
サザナミヤッコ	キンチャクダイ科
ササムロ	タカサゴ科
サザングラブフィッシュ	トラギス科
サザンスティングレイ	アカエイ科
サザンラス	ベラ科
サドルテールグルーパ	ハタ科
サドルドブレニー	ラブリソムス科
サドルバックバタフライフィッシュ	チョウチョウウオ科
サドルラス	ベラ科
サバヒー	サバヒー科
サビウツボ	ウツボ科
サビハゼ	ハゼ科
サファイアハゼ	ハゼ科
サヤマツカサ	イットウダイ科
サラサゴンベ	ゴンベ科
サラサハゼ	ハゼ科
サラサハタ	ハタ科
サンカクハゼ	ハゼ科
サンギルイシモチ	テンジクダイ科
サンゴアイゴ	アイゴ科
ザンジバルバタフライフィッシュ	チョウチョウウオ科
サンドシラゴ	キス科
サンドタイルフィッシュ	キツネアマダイ科
シーザーグラント	イサキ科
シールズカーディナルフィッシュ	テンジクダイ科
シイラ	シイラ科
シコクスズメダイ	スズメダイ科
シコンハタタテハゼ	クロユリハゼ科
シザーテールクロミス	スズメダイ科
シシマイギンポ	イソギンポ科
シチセンスズメダイ	スズメダイ科
シチセンチョウチョウウオ	チョウチョウウオ科
シチセンベラ	ベラ科
シチセンムスメベラ	ベラ科
シックスプレートソウテール	ニザダイ科
シテンチョウチョウウオ	チョウチョウウオ科
シテンヤッコ	キンチャクダイ科
シドニーカーディナルフィッシュ	テンジクダイ科
シノビハゼ	ハゼ科
シボリキンチャクフグ	フグ科
シマアジ	アジ科
シマイサキ	シマイサキ科
シマウシノシタ	ササウシノシタ科
シマウミスズメ	ハコフグ科
シマオリハゼ	ハゼ科
シマキンチャクフグ	フグ科
シマギンポ	イソギンポ科
シマクダリボウズギスモドキ	テンジクダイ科
シマスズメダイ	スズメダイ科
シマタレクチベラ	ベラ科
シマハギ	ニザダイ科
シマハタタテダイ	チョウチョウウオ科
シマヒメヤマノカミ	フサカサゴ科
シマメジナ	イスズミ科
シマヤッコ	キンチャクダイ科
シミラーダムゼル	スズメダイ科
シモフリタナバタウオ	タナバタウオ科
シモフリフエフキ	フエフキダイ科
シャークノーズゴビー	ハゼ科
シャークマカレル	サバ科
シャープノーズパファー	フグ科
ジャイアントジョーフィッシュ	アゴアマダイ科
ジャイアントスイートリップス	イサキ科
ジャイアントダムセルフィッシュ	スズメダイ科
ジャイアントホークフィッシュ	ゴンベ科
ジャックデンプシー	カワスズメ科
ジャワラビットフィッシュ	アイゴ科
ジュウモンジサラサハゼ	ハゼ科
シュローダーズコームトゥースブレニー	イソギンポ科
ショートストライプゴビー	ハゼ科
ショートスナウトクロミス	スズメダイ科
ショートノーズラス	ベラ科
ショートフィンパイプフィッシュ	ヨウジウオ科
ショートポーチピグミーパイプホース	ヨウジウオ科
ジョルトヘッドポギー	タイ科
シラコダイ	チョウチョウウオ科
シラタキベラ	ベラ科
シラタキベラダマシ	ベラ科
シリウスベニハゼ	ハゼ科
シリキルリスズメダイ	スズメダイ科
シルバースイープ	イスズミ科
シルバードラマー	イスズミ科
シロイソハゼ	ハゼ科
シロオビイソハゼ	ハゼ科
シロオビハゼ	ハゼ科
シロオビブダイ	ブダイ科
シロギス	キス科
シロタスキベラ	ベラ科
シロブチハタ	ハタ科
シロワニ	オオワニザメ科
シンジュアナゴ	アナゴ科
シンジュタマガシラ	イトヨリダイ科
ジンベエザメ	ジンベエザメ科
スールーファングブレニー	イソギンポ科
スイ	カジカ科
スエズフュージラー	タカサゴ科
スカーフェイスブレニー	イソギンポ科
スカシテンジクダイ	テンジクダイ科
スカンクアネモネフィッシュ	スズメダイ科
スギ	スギ科
スクールマスタースナッパー	フエダイ科
スクエアテイルファイルフィッシュ	カワハギ科
スクリブルドエンジェルフィッシュ	キンチャクダイ科
スケロクウミタケハゼ	ハゼ科
スジアラ	ハタ科
スジイシモチ	テンジクダイ科
スジオテンジクダイ	テンジクダイ科
スジグロガラスハゼ	ハゼ科
スジクロハギ	ニザダイ科
スジクロユリハゼ	クロユリハゼ科
スジタテガミカエルウオ	イソギンポ科
スジハタ	ハタ科
スジハナダイ	ハタ科
スジブダイ	ブダイ科
スジブチスズメダイ	スズメダイ科
スジベラ	ベラ科
スジモヨウフグ	フグ科
スズキ	スズキ科
スズメダイ	スズメダイ科
スズメダイモドキ	スズメダイ科
スターリーグルーパー	ハタ科
スターリードラゴネット	ネズッポ科
スターリーブレニー	イソギンポ科
スターリーラビットフィッシュ	アイゴ科
スダレカワハギ	カワハギ科
スダレチョウチョウウオ	チョウチョウウオ科
スダレヤライイシモチ	テンジクダイ科
スチールポンパーノ	アジ科
スティープヘッドパロットフィッシュ	ブダイ科
ストーンスコーピオンフィッシュ	フサカサゴ科
ストップライトパロットフィッシュ	ブダイ科
ストライプドカーディナルフィッシュ	テンジクダイ科
ストライプドパロットフィッシュ	ブダイ科
ストライプドワーフゴビー	ハゼ科
ストライプヘッドゴビー	ハゼ科
スナウトスポットゴビー	ハゼ科
スパイニークロミス	スズメダイ科
スパイニーリーフフィッシュ	ハオコゼ科
スパインチークアネモネフィッシュ	スズメダイ科
スパニッシュフラグスナッパー	フエダイ科
スパニッシュホグフィッシュ	ベラ科
スパングルドシュリンプゴビー	ハゼ科
スピンスターラス	ベラ科
スフィンクスサラサハゼ	ハゼ科
スプリンガーズダムゼル	スズメダイ科
スプレンディッドドティーバック	メギス科
スプレンディッドレオパードラス	ベラ科
スペクタクルドゴビー	ハゼ科
スペクタクルドパロットフィッシュ	ブダイ科
スペクルドサンドパーチ	トラギス科
スポッテッドギルカーディナルフィッシュ	テンジクダイ科
スポッテッドゴートフィッシュ	ヒメジ科
スポッテッドシャープノーズパファー	フグ科
スポッテッドシャープノーズパファー	フグ科
スポッテッドドラム	ニベ科
スポッテッドトランクフィッシュ	ハコフグ科
スポッテッドバタフライフィッシュ	チョウチョウウオ科
スポッテッドモレイ	ウツボ科
スポッテッドローコーラルブレニー	イソギンポ科
スポットテールコリス	ベラ科
スポットテールバタフライフィッシュ	チョウチョウウオ科
スポットテイルグラント	イサキ科
スポットライトゴビー	ハゼ科
スマ	サバ科
スミスズファングブレニー	イソギンポ科
スミゾメハナハゼ	クロユリハゼ科
スミツキカノコ	イットウダイ科
スミツキソメワケベラ	ベラ科
スミツキトノサマダイ	チョウチョウウオ科
スミツキベラ	ベラ科
スミレスズメダイ	スズメダイ科
スミレナガハナダイ	ハタ科
スミレハナハゼ	クロユリハゼ科
スムーストランクフィッシュ	ハコフグ科
スモールスケールブルズアイ	ハタンポ科
スモールマウスグラント	イサキ科
スリーストライプドウィップテール	イトヨリダイ科
スリースポットダムセルフィッシュ	スズメダイ科
スリーバードポーキュパインフィッシュ	ハリセンボン科
スリーバンデッドバタフライフィッシュ	チョウチョウウオ科
スリーラインドブレニー	イソギンポ科
スリーラインドモノクルブリーム	イトヨリダイ科
スリッパリーディック	ベラ科
スレッドフィンドティーバック	メギス科
スレッドフィンパールパーチ	アオバダイ科
セーラーズグラント	イサキ科
セーラムブレニー	イソギンポ科
セイテンベラ	ベラ科
セイルフィンキャットフィッシュ	ゴンズイ科
セイルフィングルーパー	ハタ科
セイルフィンドティーバック	メギス科
セイルフィンリボンゴビー	クロユリハゼ科
セグメンテッドブレニー	イソギンポ科
セグロキュウセン	ベラ科
セグロスズメダイ	スズメダイ科
セグロチョウチョウウオ	チョウチョウウオ科
セグロマツカサ	イットウダイ科
セジロクマノミ	スズメダイ科
セジロノドグロベラ	ベラ科
セダカカワハギ	カワハギ科
セダカギンポ	イソギンポ科
セダカクロサギ	クロサギ科
セダカスズメダイ	スズメダイ科
セダカニセメギス	メギス科
セダカヤッコ	キンチャクダイ科
セナキルリスズメダイ	スズメダイ科
セナスジベラ	ベラ科
セネターラス	ベラ科
ゼブラウツボ	ウツボ科
ゼブラハゼ	クロユリハゼ科
ゼブラバットフィッシュ	マンジュウダイ科
セホシテンジクダイ	テンジクダイ科
セミホウボウ	セミホウボウ科
セルフィンブレニー	コケギンポ科
セロ	サバ科
センニンサヨリ	サヨリ科
センネンダイ	フエダイ科
ソーサーアイポーギー	タイ科
ソウシハギ	カワハギ科
ゾスターラス	ベラ科
ソトイワシ	ソトイワシ科
ソメワケベラ	ベラ科
ソメワケヤッコ	キンチャクダイ科
ソラスズメダイ	スズメダイ科
ソロイモンガラ	モンガラカワハギ科
タイガーグルーパー	ハタ科
タイガーテールシーホース	ヨウジウオ科
ダイダイブダイ	ブダイ科
ダイヤモンドテールフェアリーラス	ベラ科
タイワンカマス	カマス科
タイワンスズメダイ	スズメダイ科
タイワンタマガシラ	イトヨリダイ科
タイワンブダイ	ブダイ科
タイワンマトイシモチ	テンジクダイ科
ダウニングズシュリンプゴビー	ハゼ科
タカクラタツ	ヨウジウオ科
タカサゴ	タカサゴ科
タカサゴスズメダイ	スズメダイ科
タカサゴヒメジ	ヒメジ科
タカノハダイ	タカノハダイ科
タカベ	イスズミ科
タキゲンロクダイ	チョウチョウウオ科
タキベラ	ベラ科
タコベラ	ベラ科
ダスキースクォーラルフィッシュ	イットウダイ科
ダスキーダムセルフィッシュ	スズメダイ科
ダスキーバンデッドモレイ	ウツボ科
ダスキーフラットヘッド	コチ科
タスキモンガラ	モンガラカワハギ科
タスジイシモチ	テンジクダイ科
タスジウミシダウバウオ	ウバウオ科
タソガレズズメダイ	スズメダイ科
タツウミヘビ	ウミヘビ科
タツウミヤッコ	ヨウジウオ科
タツノイトコ	ヨウジウオ科
タテガミカエルウオ	イソギンポ科
タテジマキンチャクダイ	キンチャクダイ科
タテシマフエフキ	フエフキダイ科
タテジマヘビギンポ	ヘビギンポ科
タテジマヤッコ	キンチャクダイ科
タテスジハタ	ハタ科
ダテハゼ	ハゼ科
ダテハゼsp	ハゼ科
タテフエダイ	フエダイ科
タテヤマベラ	ベラ科
タナバタウオ	タナバタウオ科
タバコフィッシュ	ハタ科
タヒチアンダムゼルフィッシュ	スズメダイ科
タヒチアンバタフライフィッシュ	チョウチョウウオ科
ダブルウィップテール	イトヨリダイ科
ダブルストライプドドティーバック	メギス科
ダブルバークロミス	スズメダイ科
ダブルバーゴートフィッシュ	ヒメジ科
ダブルバンドサージョンフィッシュ	ニザダイ科
タマカイ	ハタ科
タマメイチ	フエフキダイ科
タルボッツダムゼル	スズメダイ科
タレクチベラ	ベラ科
ダンゴオコゼ	ダンゴオコゼ科
タンザクハゼ	クロユリハゼ科
ダンダラスズメダイ	スズメダイ科
ダンダラダテハゼ	ハゼ科
ダンダラトラギス	トラギス科
タンポポスズメダイ	スズメダイ科
チークスポットゴビー	ハゼ科
チークドパイプフィッシュ	ヨウジウオ科
チェッカードドティーバック	メギス科
チェルブフィッシュ	キンチャクダイ科
チゴベニハゼ	ハゼ科
チビブダイ	ブダイ科
チモールラス	ベラ科
チャイニーズデモイセル	スズメダイ科
チャイニーズナムフィッシュ	タイワンシビレエイ科
チャイロマルハタ	ハタ科
チャイロヤッコ	キンチャクダイ科
チャガラ	ハゼ科
チャコールダムゼル	スズメダイ科
チョウチョウウオ	チョウチョウウオ科
チョウチョウコショウダイ	イサキ科
チョウハン	チョウチョウウオ科
チョコレートディップクロミス	スズメダイ科
チリメンアイゴ	アイゴ科
チリメンヤッコ	キンチャクダイ科
チンアナゴ	アナゴ科
ツーサドルゴートフィッシュ	ヒメジ科
ツースポットコーラルフィッシュ	チョウチョウウオ科
ツースポットブレニー	イソギンポ科
ツカエイ	アカエイ科
ツキチョウチョウウオ	チョウチョウウオ科
ツチホゼリ	ハタ科
ツッパリサギ	クロサギ科
ツノダシ	ツノダシ科
ツノハタタテダイ	チョウチョウウオ科
ツバメウオ	マンジュウダイ科
ツバメクサハゼ	ハゼ科
ツマグロ	メジロザメ科
ツマグロサンカクハゼ	ハゼ科
ツマグロチョウチョウウオ	チョウチョウウオ科
ツマグロハタンポ	ハタンポ科
ツマグロマツカサ	イットウダイ科
ツマジロ	メジロザメ科
ツマジロオコゼ	ハオコゼ科
ツマジロモンガラ	モンガラカワハギ科
ツマリテングハギ	ニザダイ科
ツムギハゼ	ハゼ科
ツムブリ	アジ科
ツユベラ	ベラ科
テールスポットブレニー	イソギンポ科
ディアナフォグフィッシュ	ベラ科
テイパーテールシュリンプゴビー	ハゼ科
ティンセルスクォーラルフィッシュ	イットウダイ科
テッポウウオ	テッポウウオ科
デニスピグミーシーホース	ヨウジウオ科
デバスズメダイ	スズメダイ科
デルタスズメダイ	スズメダイ科
テルメアジ	アジ科
テングカワハギ	カワハギ科
テングダイ	カワビシャ科
テングチョウチョウウオ	チョウチョウウオ科
テングハギ	ニザダイ科
テングハギモドキ	ニザダイ科
テングハコフグ	ハコフグ科
テンクロスジギンポ	イソギンポ科
テンジクアジ	アジ科
テンジクイサキ	イスズミ科
テンジクスズメダイ	スズメダイ科
テンス	ベラ科
テンスモドキ	ベラ科
テンツキチョウチョウウオ	チョウチョウウオ科
トゥースブラシレザージャケット	カワハギ科
トウアカクマノミ	スズメダイ科
トゥワイススポッテッドソープフィッシュ	ハタ科
トカラベラ	ベラ科
トガリエビス	イットウダイ科
ドクウツボ	ウツボ科
トゲダルマガレイ	ダルマガレイ科
トゲチョウチョウウオ	チョウチョウウオ科
トサカハギ	ニザダイ科
ドチザメ	ドチザメ科
ドッテッドフェアリーラス	ベラ科
ドットアンドダッシュバタフライフィッシュ	チョウチョウウオ科
トノサマダイ	チョウチョウウオ科
トノズラス	ベラ科
トビエイ	トビエイ科
トマリヒイロテンジクダイ	テンジクダイ科
トミニサージョンフィッシュ	ニザダイ科
トライアングルバタフライフィッシュ	チョウチョウウオ科
トラウツボ	ウツボ科
トラギス	トラギス科
ドラキュラシュリンプゴビー	ハゼ科
トラフザメ	トラフザメ科
トランペットフィッシュ	ヘラヤガラ科
トリカラーブレニー	イソギンポ科
トリコロールパロットフィッシュ	ブダイ科
ドロップオフサージョンフィッシュ	ニザダイ科
トワイライトファングブレニー	イソギンポ科
トンガシノビハゼ	ハゼ科
トンガリサカタザメ	サカタザメ科
トンプソンチョウチョウウオ	チョウチョウウオ科
ナイトサージェント	スズメダイ科
ナイフレイザーフィッシュ	ベラ科
ナガコバン	コバンザメ科
ナガサキスズメダイ	スズメダイ科
ナガテングハギモドキ	ニザダイ科
ナガニザ	ニザダイ科
ナガハナダイ	ハタ科
ナガブダイ	ブダイ科
ナカモトイロワケハゼsp	ハゼ科
ナッソウグルーパー	ハタ科
ナベカ	イソギンポ科
ナミウツボ	ウツボ科
ナミスズメダイ	スズメダイ科
ナミダクロハギ	ニザダイ科
ナミダテンジクダイ	テンジクダイ科
ナミハタ	ハタ科
ナミフエダイ	フエダイ科
ナメラベラ	ベラ科
ナメラヤッコ	キンチャクダイ科
ナンヨウカイワリ	アジ科
ナンヨウツバメウオ	マンジュウダイ科
ナンヨウハギ	ニザダイ科
ナンヨウブダイ	ブダイ科
ナンヨウマンタ	トビエイ科
ニードルスパインコーラルゴビー	ハゼ科
ニザダイ	ニザダイ科
ニシアカエソ	エソ科
ニジエビス	イットウダイ科
ニシキアナゴ	アナゴ科
ニシキイトヒキベラ	ベラ科
ニシキオオメワラスボ	オオメワラスボ科
ニシキキュウセン	ベラ科
ニシキテグリ	ネズッポ科
ニシキハゼ	ハゼ科
ニシキフウライウオ	カミソリウオ科
ニシキブダイ	ブダイ科
ニシキベラ	ベラ科
ニシキヤッコ	キンチャクダイ科
ニジギンポ	イソギンポ科
ニジコショウダイ	イサキ科
ニジハギ	ニザダイ科
ニジハタ	ハタ科
ニジョウサバ	サバ科
ニセカンランハギ	ニザダイ科
ニセクラカオスズメダイ	スズメダイ科
ニセクロホシフエダイ	フエダイ科
ニセゴイシウツボ	ウツボ科
ニセタカサゴ	タカサゴ科
ニセネッタイスズメダイ	スズメダイ科
ニセフウライチョウチョウウオ	チョウチョウウオ科
ニセモチノウオ	ベラ科
ニセモンツキスズメダイ	スズメダイ科
ニタリ	オナガザメ科
ニチリンダテハゼ	ハゼ科
ニテンエソ	エソ科
ニューギニアベラ	ベラ科
ニュージーランドマアジ	アジ科
ニュウドウダテハゼ	ハゼ科
ニラミギンポ	イソギンポ科
ニラミハナダイ	ハタ科
ニンギョウベニハゼ	ハゼ科
ヌノサラシ	ハタ科
ヌリワケカワハギ	カワハギ科
ネオンテンジクダイ	テンジクダイ科
ネコザメ	ネコザメ科
ネジリンボウ	ハゼ科
ネズスズメダイ	スズメダイ科
ネズミフエダイ	フエダイ科
ネズミフグ	ハリセンボン科
ネッタイスズメダイ	スズメダイ科
ネッタイミノカサゴ	フサカサゴ科
ネムリブカ	メジロザメ科
ネンブツダイ	テンジクダイ科
ノーズライングラブフィッシュ	トラギス科
ノーフォークカーディナルフィッシュ	テンジクダイ科
ノコギリダイ	フエフキダイ科
ノコギリハギ	カワハギ科
ノドグロベラ	ベラ科
ノボリエビス	イットウダイ科
バージェスバタフライフィッシュ	チョウチョウウオ科
バージャック	アジ科
バースポットカーディナルフィッシュ	テンジクダイ科
ハーツフェルドズカーディナルフィッシュ	テンジクダイ科
バーテルドラゴネット	ネズッポ科
バードハムレット	ハタ科
バートレットアンティアス	ハタ科
バーバーフィッシュ	チョウチョウウオ科
ハーフアンドハーフクロミス	スズメダイ科
ハーフバンデッドシーパーチ	ハタ科
ハーフムーントリガーフィッシュ	モンガラカワハギ科
パープルビューティー	ハタ科
パーミット	アジ科
パーリーレイザーフィッシュ	ベラ科
パールトビー	フグ科
パールラス	ベラ科
ハーレクインバス	ハタ科
バーレッドセラーノ	ハタ科
バーローズダムゼル	スズメダイ科
バイカラーダムセルフィッシュ	スズメダイ科
バイカラードティーバック	メギス科
ハイフィンパロットフィッシュ	ブダイ科
パウダーブルーサージョンフィッシュ	ニザダイ科
ハオコゼ	ハオコゼ科
ハガツオ	サバ科
ハクセイハギ	カワハギ科
ハクセンタマガシラ	イトヨリダイ科
ハクテンカタギ	チョウチョウウオ科
ハクテンハタ	ハタ科
ハゲヒラベラ	ベラ科
ハゲブダイ	ブダイ科
ハコフグ	ハコフグ科
ハコベラ	ベラ科
ハシナガウバウオ	ウバウオ科
ハシナガチョウチョウウオ	チョウチョウウオ科
ハシナガベラ	ベラ科
パシフィッククレオレフィッシュ	ハタ科
パシフィックシーホース	ヨウジウオ科
パシフィックハーフビーク	サヨリ科
パシフィックポーギー	タイ科
パシフィックムートンハムレット	ハタ科
バショウカジキ	マカジキ科
バスズコームトゥースブレニー	イソギンポ科
パステルグリーンラス	ベラ科
バターハムレット	ハタ科
ハダカハオコゼ	フサカサゴ科
ハタタテガレイ	ベロガレイ科
ハタタテギンポ	イソギンポ科
ハタタテサンカクハゼ	ハゼ科
ハタタテシノビハゼ	ハゼ科
ハタタテダイ	チョウチョウウオ科
ハタタテハゼ	クロユリハゼ科
バタンタドティーバック	メギス科
ハチマキダテハゼ	ハゼ科
バックスパインフェアリーゴビー	ハゼ科
バツナダムゼル	スズメダイ科
ハナアイゴ	アイゴ科
ハナキンチャクフグ	フグ科
ハナグロチョウチョウウオ	チョウチョウウオ科
ハナゴイ	ハタ科
ハナゴンベ	ハタ科
ハナダイギンポ	イソギンポ科
ハナダイダマシ	スズメダイ科
ハナタカサゴ	タカサゴ科
ハナタツ	ヨウジウオ科
ハナツノハギ	カワハギ科
ハナナガスズメダイ	スズメダイ科
ハナナガモチノウオ	ベラ科
バナナフュージラー	タカサゴ科
ハナハゼ	クロユリハゼ科
ハナヒゲウツボ	ウツボ科
ハナビラウツボ	ウツボ科
ハナビラクマノミ	スズメダイ科
ハナフエフキ	フエフキダイ科
パナマグレイスビー	ハタ科
パナマポークフィッシュ	イサキ科
パナミックグリーンモレイ	ウツボ科
パナミックサージェントメジャー	スズメダイ科
パナミックソルダーフィッシュ	イットウダイ科
ハナミノカサゴ	フサカサゴ科
ハニカムカウフィッシュ	ハコフグ科
バフクロミス	スズメダイ科
ハマクマノミ	スズメダイ科
ハマダツ	ダツ科
ハマフエフキ	フエフキダイ科
バミューダシーチャブ	イスズミ科
ハラスジベラ	ベラ科
バラハタ	ハタ科
バラフエダイ	フエダイ科
バリアブルトルペドレイ	ヤマトシビレエイ科
バリアブルラインドフュージュラー	タカサゴ科
バリアリーフアネモネフィッシュ	スズメダイ科
ハリセンボン	ハリセンボン科
パリッドゴビー	ハゼ科
バルギバンティピグミーシーホース	ヨウジウオ科
バルドスポットモノクルブリーム	イトヨリダイ科
ハワイアンクリーナーラス	ベラ科
ハワイアンシュリンプゴビー	ハゼ科
ハワイアンダッシラス	スズメダイ科
ハワイアンチャブ	イスズミ科
ハワイアンバイカラークロミス	スズメダイ科
ハワイアンフラッグテール	ユゴイ科
ハワイアンホワイトスポッテッドトビー	フグ科
ハワイトラギス	トラギス科
パンダダルマハゼ	ハゼ科
バンディッドバタフライフィッシュ	チョウチョウウオ科
バンデッドトードフィッシュ	ガマアンコウ科
バンデッドレインボーラス	ベラ科
バンプヘッドダムセルフィッシュ	スズメダイ科
バンプヘッドパロットフィッシュ	ブダイ科
ピーコックフラウンダー	ダルマガレイ科
ヒイロモチノウオ	ベラ科
ヒオドシベラ	ベラ科
ビオラリボンスズメダイ	スズメダイ科
ヒカリキンメダイ	ヒカリキンメダイ科
ヒガンフグ	フグ科
ピクチャードラゴネット	ネズッポ科
ピグミーシードラゴン	ヨウジウオ科
ヒゲダイ	ヒゲダイ科
ヒゲニジギンポ	イソギンポ科
ヒシカイワリ	アジ科
ピックハンドルバラクーダ	カマス科
ビッグフィンシュリンプゴビー	ハゼ科
ヒトスジイシモチ	テンジクダイ科
ヒトスジエソ	エソ科
ヒトスジギンポ	イソギンポ科
ヒトスジタマガシラ	イトヨリダイ科
ヒトスジモチノウオ	ベラ科
ヒトヅラハリセンボン	ハリセンボン科
ヒトミシリハゼ	ハゼ科
ヒトミハタ	ハタ科
ヒノマルハゼ	ハゼ科
ヒバシヨウジ	ヨウジウオ科
ヒフキアイゴ	アイゴ科
ヒブダイ	ブダイ科
ヒマワリスズメダイ	スズメダイ科
ヒメアイゴ	アイゴ科
ヒメアオギハゼ	ハゼ科
ヒメウツボ	ウツボ科
ヒメオニオコゼ	オニオコゼ科
ヒメキンチャクフグ	フグ科
ヒメゴンベ	ゴンベ科
ヒメサンゴカサゴ	フサカサゴ科
ヒメシノビハゼ	ハゼ科
ヒメスズメダイ	スズメダイ科
ヒメダツ	ダツ科
ヒメダテハゼ	ハゼ科
ヒメタマガシラ	イトヨリダイ科
ヒメツバメウオ	ヒメツバメウオ科
ヒメテングハギ	ニザダイ科
ヒメニセモチノウオ	ベラ科
ヒメニラミベニハゼ	ハゼ科
ヒメフウライチョウチョウウオ	チョウチョウウオ科
ヒメフエダイ	フエダイ科
ヒメホシハゼ	ハゼ科
ビューグレゴリ	スズメダイ科
ビューズラス	ベラ科
ビューブランメル	スズメダイ科
ヒョウモンオトメエイ	アカエイ科
ヒラシュモクザメ	シュモクザメ科
ヒラテンジクダイ	テンジクダイ科
ヒラニザ	ニザダイ科
ヒラベラ	ベラ科
ヒラマサ	アジ科
ヒラメ	ヒラメ科
ヒレオビウツボ	ウツボ科
ヒレグロイットウダイ	イットウダイ科
ヒレグロコショウダイ	イサキ科
ヒレグロスズメダイ	スズメダイ科
ヒレグロベラ	ベラ科
ヒレナガカンパチ	アジ科
ヒレナガスズメダイ	スズメダイ科
ヒレナガネジリンボウ	ハゼ科
ヒレナガハギ	ニザダイ科
ヒレナガヤッコ	キンチャクダイ科
ヒレフリサンカクハゼ	ハゼ科
ヒレボシミノカサゴ	フサカサゴ科
ピンクカーディナルフィッシュ	テンジクダイ科
ピンクスペックルドシュリンプゴビー	ハゼ科
ピンクヘッドドティーバック	メギス科
ピンフィッシュ	タイ科
フーデットカーペットシャーク	テンジクザメ科
ファイブサドルパロットフィッシュ	ブダイ科
ファイブスパインフェアリーゴビー	ハゼ科
ファインスケールドドティーバック	メギス科
ファインスケールトリガーフィッシュ	モンガラカワハギ科
ファインスポッテッドジョーフィッシュ	アゴアマダイ科
フィラメンタスラス	ベラ科
フィリピンクロミス	スズメダイ科
フィリピンスズメダイ	スズメダイ科
フィリピンブレニー	イソギンポ科
フウライチョウチョウウオ	チョウチョウウオ科
フウライボラ	ボラ科
フェアリーバスレット	グランマ科
フェザードリバーガーフィッシュ	サヨリ科
フェミニンラス	ベラ科
フエヤッコダイ	チョウチョウウオ科
フォーアイバタフライフィッシュ	チョウチョウウオ科
フォークテイルドワーフゴビー	ハゼ科
フォーサドルグルーパー	ハタ科
フォックスフェイス	アイゴ科
フカミスズメダイ	スズメダイ科
フジイロフエダイ	フエダイ科
ブダイ	ブダイ科
ブダイベラ	ベラ科
フタイロカエルウオ	イソギンポ科
フタイロハナゴイ	ハタ科
フタスジタマガシラ	イトヨリダイ科
フタスジハゼ	ハゼ科
フタスジヒメジ	ヒメジ科
フタスジリュウキュウスズメダイ	スズメダイ科
フタホシキツネベラ	ベラ科
フタホシタカノハハゼ	ハゼ科
ブチアイゴ	アイゴ科
ブチススキベラ	ベラ科
フチドリカワハギ	カワハギ科
フチドリスズメダイ	スズメダイ科
フチドリハナダイ	ハタ科
ブチハゼ	ハゼ科
ブチブダイ	ブダイ科
フックフィンカーディナルフィッシュ	テンジクダイ科
ブッリトグラント	イサキ科
プディングワイフラス	ベラ科
ブライドルドゴビー	ハゼ科
ブライドルドモノクルブリーム	イトヨリダイ科
ブラウンガーデンイール	アナゴ科
ブラウンクロミス	スズメダイ科
ブラウンチークブレニー	コケギンポ科
ブラウンバンデッドドティバック	メギス科
ブラックアイラビットフィッシュ	アイゴ科
ブラックガーデンイール	アナゴ科
ブラックグルーパー	ハタ科
ブラックスキップジャック	サバ科
ブラックストライプコリス	ベラ科
ブラックストライプセイラマ	イサキ科
ブラックストライプドコームトゥースブレニー	イソギンポ科
ブラックスピアシュリンプゴビー	ハゼ科
ブラックスポットコーラルブレニー	イソギンポ科
ブラックスポットダムゼル	スズメダイ科
ブラックチップカーディナルフィッシュ	テンジクダイ科
ブラックチップドブルズアイ	ハタンポ科
ブラックチップバスレット	グランマ科
ブラックバードラス	ベラ科
ブラックバタフライフィッシュ	チョウチョウウオ科
ブラックハムレット	ハタ科
ブラックバンデッドデモイゼル	スズメダイ科
ブラックピラミッドバタフライフィッシュ	チョウチョウウオ科
ブラックフィンスレーティ	イサキ科
ブラックフィンバラクーダ	カマス科
ブラックフラグサンドパーチ	トラギス科
ブラックフラップブレニー	イソギンポ科
ブラックベリーゴビー	ハゼ科
ブラックレオパードラス	ベラ科
ブラントヘッドトリガーフィッシュ	モンガラカワハギ科
ブリ	アジ科
ブリーカーズダムゼル	スズメダイ科
プリンセスパロットフィッシュ	ブダイ科
ブルーアクシルクロミス	スズメダイ科
ブルーアンドイエローグルーパー	ハタ科
ブルーアンドイエロークロミス	スズメダイ科
ブルーアンドゴールドスナッパー	フエダイ科
ブルーエンジェルフィッシュ	キンチャクダイ科
ブルークロミス	スズメダイ科
ブルーシュリンプゴビー	ハゼ科
ブルースアイスティングレイ	ウロトリゴン科
ブルースアイパファー	フグ科
ブルーストライプドグラント	イサキ科
ブルーストリークダムゼルフィッシュ	スズメダイ科
ブルースポッテッドジョーフィッシュ	アゴアマダイ科
ブルースポッテッドトビー	フグ科
ブルースポッテッドハインド	ハタ科
ブルースポットスティングレイ	アカエイ科
ブルースポットデモイゼル	スズメダイ科
ブルータスクフィッシュ	ベラ科
ブルータング	ニザダイ科
ブルーテイルドシュリンプゴビー	ハゼ科
ブルーデビルフィッシュ	タナバタウオ科
ブルーバードドワーフゴビー	ハゼ科
ブルーバードリボンゴビー	クロユリハゼ科
ブルーバックダムゼル	スズメダイ科
ブルーバンデッドゴビー	ハゼ科
ブルーフラッシャーラス	ベラ科
ブルーブロンズチャブ	イスズミ科
ブルーヘッド	ベラ科
ブルーラインドゴートフィッシュ	ヒメジ科
ブルーラインドサージョンフィッシュ	ニザダイ科
ブルーラインドラス	ベラ科
ブルーランナー	アジ科
ブルズアイピグミーゴビー	ハゼ科
フレームアンティアス	ハタ科
フレームエンジェルフィッシュ	キンチャクダイ科
プレーヤースコーピオンフィッシュ	フサカサゴ科
フレイムフィッシュ	テンジクダイ科
フレックルドハインド	ハタ科
フレンチエンジェルフィッシュ	キンチャクダイ科
フレンチグラント	イサキ科
フロストフィンカーディナルフィッシュ	テンジクダイ科
フロッピーテールドティーバック	メギス科
ペールリップドサージョンフィッシュ	ニザダイ科
ペインテッドアンティアス	ハタ科
ペインテッドスイートリップス	イサキ科
ペガススベニハゼ	ハゼ科
ヘコアユ	ヘコアユ科
ヘダイ	タイ科
ベニカエルアンコウ	カエルアンコウ科
ベニゴンベ	ゴンベ科
ベニチョウチョウウオ	チョウチョウウオ科
ベニツケタテガミカエルウオ	イソギンポ科
ベニヒレイトヒキベラ	ベラ科
ベニマツカサ	イットウダイ科
ペパーミントゴビー	ハゼ科
ヘビギンポ	ヘビギンポ科
ベラギンポ	ベラギンポ科
ヘラヤガラ	ヘラヤガラ科
ヘラルドコガネヤッコ	キンチャクダイ科
ペリカンバラクーダ	カマス科
ヘリゴイシウツボ	ウツボ科
ヘリングケール	オダクス科
ベルテッドカーディナルフィッシュ	テンジクダイ科
ベルテッドラス	ベラ科
ペレスメジロザメ	メジロザメ科
ベンガルフエダイ	フエダイ科
ベンガルホグフィッシュ	ベラ科
ベンケイハゼ	ハゼ科
ホースアイジャック	アジ科
ホイットレイズボックスフィッシュ	ハコフグ科
ボウズハギ	ニザダイ科
ホウセキカサゴ	フサカサゴ科
ホウセキキントキ	キントキダイ科
ホウライヒメジ	ヒメジ科
ボガ	イサキ科
ホクトベラ	ベラ科
ホグフィッシュ	ベラ科
ホクロキュウセン	ベラ科
ホシカイワリ	アジ科
ホシカザリハゼ	ハゼ科
ホシギンポ	イソギンポ科
ホシクズベニハゼ	ハゼ科
ホシゴンベ	ゴンベ科
ホシササノハベラ	ベラ科
ホシザヨリ	サヨリ科
ホシススキベラ	ベラ科
ホシゾラハゼ	ハゼ科
ホシテンス	ベラ科
ホシノハゼ	ハゼ科
ホシハゼ	ハゼ科
ホシモンガラ	モンガラカワハギ科
ホソカマス	カマス科
ホソスジナミダテンジクダイ	テンジクダイ科
ホソスジマンジュウイシモチ	テンジクダイ科
ホソタカサゴ	タカサゴ科
ホソヒラアジ	アジ科
ホソフウライウオ	カミソリウオ科
ホソフエダイ	フエダイ科
ホタルビサンゴアマダイ	キツネアマダイ科
ポッターズエンジェルフィッシュ	キンチャクダイ科
ホテイベニハゼ	ハゼ科
ホホスジタルミ	フエダイ科
ホホスジモチノウオ	ベラ科
ホホワキュウセン	ベラ科
ホムラダマシ	ハゼ科
ホムラハゼ	ハゼ科
ボロジノハナスズキ	ハタ科
ホワイトアイシュリンプゴビー	ハゼ科
ホワイトイヤースケーリーフィン	スズメダイ科
ホワイトグラント	イサキ科
ホワイトサドルゴートフィッシュ	ヒメジ科
ホワイトショルダードウィップテール	イトヨリダイ科
ホワイトスターカーディナルフィッシュ	テンジクダイ科
ホワイトスポッテッドガーデンイール	アナゴ科
ホワイトスポッテッドファイルフィッシュ	カワハギ科
ホワイトダムゼル	スズメダイ科
ホワイトテールドサージョンフィッシュ	ニザダイ科
ホワイトバードリーフゴビー	ハゼ科
ホワイトベリーラス	ベラ科
ホワイトボンネットアネモネフィッシュ	スズメダイ科
ホワイトマーゲイト	イサキ科
ホワイトマレット	ボラ科
ホワイトラインカーディナルフィッシュ	テンジクダイ科
ホワイトラインドブレニー	イソギンポ科
ホワイトラインピグミーゴビー	ハゼ科
ホンソメワケベラ	ベラ科
ポントヒピグミーシーホース	ヨウジウオ科
ホンベラ	ベラ科
マアジ	アジ科
マウデズシュリンプゴビー	ハゼ科
マオリグルーパー	ハタ科
マオリラス	ベラ科
マゴチ	コチ科
マサカリトサカハギ	ニザダイ科
マジリアイゴ	アイゴ科
マスクドゴビー	ハゼ科
マスクドシュリンプゴビー	ハゼ科
マスクドパファー	フグ科
マゼンタストリークトラス	ベラ科
マダイ	タイ科
マダガスカルバタフライフィッシュ	チョウチョウウオ科
マタナゴ	ウミタナゴ科
マダラエイ	アカエイ科
マダラエソ	エソ科
マダラカザリハゼ	ハゼ科
マダラタルミ	フエダイ科
マダラトビエイ	トビエイ科
マダラトラギス	トラギス科
マダラハタ	ハタ科
マッコスカーズフラッシャーラス	ベラ科
マッシュルームコーラルパイプフィッシュ	ヨウジウオ科
マツバギンポ	イソギンポ科
マツバスズメダイ	スズメダイ科
マテアジ	アジ科
マトフエフキ	フエフキダイ科
マトンスナッパー	フエダイ科
マブタシマアジ	アジ科
マホガニースナッパー	フエダイ科
マラヤンクロミス	スズメダイ科
マルクチヒメジ	ヒメジ科
マルコバン	アジ科
マルサヨリ	サヨリ科
マルスズメダイ	スズメダイ科
マルチカラーエンジェルフィッシュ	キンチャクダイ科
マルチスパインダムゼルフィッシュ	スズメダイ科
マンジュウイシモチ	テンジクダイ科
マンボウ	マンボウ科
ミカゲハゼ	ハゼ科
ミカヅキツバメウオ	マンジュウダイ科
ミカドチョウチョウウオ	チョウチョウウオ科
ミギマキ	タカノハダイ科
ミクロネシアダムゼル	スズメダイ科
ミクロネシアンラス	ベラ科
ミジンベニハゼ	ハゼ科
ミスジアカヒレイシモチ	テンジクダイ科
ミスジスズメダイ	スズメダイ科
ミスジチョウチョウウオ	チョウチョウウオ科
ミスジリュウキュウスズメダイ	スズメダイ科
ミズタマハゼ	ハゼ科
ミズン	ニシン科
ミゾレチョウチョウウオ	チョウチョウウオ科
ミゾレフグ	フグ科
ミツバイソハゼ	ハゼ科
ミツバモチノウオ	ベラ科
ミツボシキュウセン	ベラ科
ミツボシクロスズメダイ	スズメダイ科
ミツボシモチノウオ	ベラ科
ミナミアカエソ	エソ科
ミナミイケカツオ	アジ科
ミナミイスズミ	イスズミ科
ミナミイソハゼ	ハゼ科
ミナミウシノシタ	ササウシノシタ科
ミナミギンポ	イソギンポ科
ミナミクロサギ	クロサギ科
ミナミゴンズイ	ゴンズイ科
ミナミゴンベ	ゴンベ科
ミナミタカサゴ	タカサゴ科
ミナミダテハゼ	ハゼ科
ミナミハコフグ	ハコフグ科
ミナミハタ	ハタ科
ミナミハタタテダイ	チョウチョウウオ科
ミナミハタンポ	ハタンポ科
ミナミフエダイ	フエダイ科
ミナミフトスジイシモチ	テンジクダイ科
ミナミホタテウミヘビ	ウミヘビ科
ミニダーツゴビー	ハゼ科
ミノカサゴ	フサカサゴ科
ミミックカーディナルフィッシュ	テンジクダイ科
ミミックカーディナルフィッシュ	テンジクダイ科
ミヤケテグリ	ネズッポ科
ミヤケベラ	ベラ科
ミヤコイシモチ	テンジクダイ科
ミヤコキセンスズメダイ	スズメダイ科
ミヤコテングハギ	ニザダイ科
ミレットシードバタフライフィッシュ	チョウチョウウオ科
ムーンスポッテッドシュリンプゴビー	ハゼ科
ムシクイアイゴ	アイゴ科
ムスジコショウダイ	イサキ科
ムスメハギ	モンガラカワハギ科
ムスメベラ	ベラ科
ムツ	ムツ科
ムナグロアジ	アジ科
ムナテンブダイ	ブダイ科
ムナテンベラダマシ	ベラ科
ムネアカクチビ	フエフキダイ科
ムラサキメダイ	タイ科
ムラサメハゼ	ハゼ科
ムラサメモンガラ	モンガラカワハギ科
ムラルゴビー	ハゼ科
ムレハタタテダイ	チョウチョウウオ科
メアジ	アジ科
メイキュウサザナミハギ	ニザダイ科
メイタイシガキフグ	ハリセンボン科
メイチダイ	フエフキダイ科
メガネウマヅラハギ	カワハギ科
メガネクロハギ	ニザダイ科
メガネゴンベ	ゴンベ科
メガネスズメダイ	スズメダイ科
メガネハギ	モンガラカワハギ科
メガネベニハゼ	ハゼ科
メガネモチノウオ	ベラ科
メガレイ	ヒラメ科
メキシカンゴートフィッシュ	ヒメジ科
メキシカンバラクーダ	カマス科
メキシカンホグフィッシュ	ベラ科
メギス	メギス科
メジナ	イスズミ科
メタリックシュリンプゴビー	ハゼ科
メニースパインドエンジェルフィッシュ	キンチャクダイ科
メニーラインドカーディナルフィッシュ	テンジクダイ科
メラネシアンアンティアス	ハタ科
メロンバタフライフィッシュ	チョウチョウウオ科
モーレアアンティアス	ハタ科
モザイクレザージャケット	カワハギ科
モナークダムゼル	スズメダイ科
モブラ	トビエイ科
モヨウハタ	ハタ科
モヨウフグ	フグ科
モヨウモンガラドオシ	ウミヘビ科
モルジブアネモネフィッシュ	スズメダイ科
モルジブトリプルフィン	ヘビギンポ科
モルッセンカーディナル	テンジクダイ科
モロコシハギ	カワハギ科
モンガラカワハギ	モンガラカワハギ科
モンキキンチャクフグ	フグ科
モンスズメダイ	スズメダイ科
モンダルマガレイ	ダルマガレイ科
モンツキアカヒメジ	ヒメジ科
モンツキカエルウオ	イソギンポ科
モンツキスズメダイ	スズメダイ科
モンツキハギ	ニザダイ科
モンツキベラ	ベラ科
モンヒラベラ	ベラ科
ヤイトハタ	ハタ科
ヤイトヤッコ	キンチャクダイ科
ヤエヤマギンポ	イソギンポ科
ヤシャハゼ	ハゼ科
ヤシャベラ	ベラ科
ヤスジチョウチョウウオ	チョウチョウウオ科
ヤスジニセモチノウオ	ベラ科
ヤセアマダイ	キツネアマダイ科
ヤッコエイ	アカエイ科
ヤツシハゼsp	ハゼ科
ヤノウキホシハゼ	ハゼ科
ヤノスソビキハゼ	ハゼ科
ヤノダテハゼ	ハゼ科
ヤマシロベラ	ベラ科
ヤマブキスズメダイ	スズメダイ科
ヤマブキハゼ	ハゼ科
ヤマブキベラ	ベラ科
ヤミスズキ	ハタ科
ヤミハタ	ハタ科
ヤライイシモチ	テンジクダイ科
ヤリイシモチ	テンジクダイ科
ヤリカタギ	チョウチョウウオ科
ヤンシーズパイプフィッシュ	ヨウジウオ科
ヤンセンニシキベラ	ベラ科
ユウゼン	チョウチョウウオ科
ユウダチタカノハ	タカノハダイ科
ユウダチタルミ	フエダイ科
ユカタイシモチ	テンジクダイ科
ユカタハタ	ハタ科
ユメウメイロ	タカサゴ科
ユメハタンポ	ハタンポ科
ヨコジマアイゴ	アイゴ科
ヨコシマクロダイ	フエフキダイ科
ヨコシマサワラ	サバ科
ヨコシマタマガシラ	イトヨリダイ科
ヨコシマハギ	ニザダイ科
ヨゴレアオダイ	フエダイ科
ヨゴレヘビギンポ	ヘビギンポ科
ヨゴレマツカサ	イットウダイ科
ヨスジニセモチノウオ	ベラ科
ヨスジフエダイ	フエダイ科
ヨスジリュウキュウスズメダイ	スズメダイ科
ヨソギ	カワハギ科
ヨツメトラギス	トラギス科
ヨメヒメジ	ヒメジ科
ヨロイアジ	アジ科
ヨロイウオ	ヘコアユ科
ヨロンスズメダイ	スズメダイ科
ラージスケールフラットヘッド	コチ科
ラージバンデッドブレニー	イソギンポ科
ライアテールドティーバック	メギス科
ラインスポットフラッシャーラス	ベラ科
ラインドフェアリーラス	ベラ科
ラウンドサルディネラ	ニシン科
ラウンドスティングレイ	ヒラタエイ科
ラグーンシュリンプゴビー	ハゼ科
ラクダハコフグ	ハコフグ科
ラジャアンパットトードフィッシュ	ガマアンコウ科
ラジャエポーレットシャーク	テンジクザメ科
ラボックスコームトゥースブレニー	イソギンポ科
ラボックスフェアリーラス	ベラ科
ランタンバス	ハタ科
ランドールズフュージラー	タカサゴ科
リザードトリプルフィン	ヘビギンポ科
リトルコームトゥースブレニー	イソギンポ科
リトルファイルフィッシュ	カワハギ科
リボンスイートリップス	イサキ科
リュウキュウダツ	ダツ科
リュウキュウニセスズメ	メギス科
リュウキュウヒメジ	ヒメジ科
リュウキュウヤライイシモチ	テンジクダイ科
リュウグウベラ	ベラ科
リュウグウベラギンポ	ベラギンポ科
リングアイジョーフィッシュ	アゴアマダイ科
リングテールサージョンフィッシュ	ニザダイ科
ルクスリアカーディナルフィッシュ	テンジクダイ科
ルソンイトヒキベラ	ベラ科
ルソンゴートフィッシュ	ヒメジ科
ルリスズメダイ	スズメダイ科
ルリホシスズメダイ	スズメダイ科
ルリメイシガキスズメダイ	スズメダイ科
ルリヤッコ	キンチャクダイ科
レーザーサージョンフィッシュ	ニザダイ科
レイズダムゼル	スズメダイ科
レイドシュリンプゴビー	ハゼ科
レインフォーズゴビー	ハゼ科
レインフォーズバタフライフィッシュ	チョウチョウウオ科
レインボーパロットフィッシュ	ブダイ科
レオパードグルーパー	ハタ科
レッドアンドブラックアネモネフィッシュ	スズメダイ科
レッドサドルバックアネモネフィッシュ	スズメダイ科
レッドシーゴートフィッシュ	ヒメジ科
レッドシーバナーフィッシュ	チョウチョウウオ科
レッドシーラクーンバタフライフィッシュ	チョウチョウウオ科
レッドスポッテッドドワーフゴビー	ハゼ科
レッドスポッテッドホークフィッシュ	ゴンベ科
レッドスポットドティーバック	メギス科
レッドバードホークフィッシュ	ゴンベ科
レッドハインド	ハタ科
レッドバックバタフライフィッシュ	チョウチョウウオ科
レッドバンデッドプラウンゴビー	ハゼ科
レッドバンドパロットフィッシュ	ブダイ科
レッドフィンパロットフィッシュ	ブダイ科
レッドヘッドゴビー	ハゼ科
レッドマージンシュリンプゴビー	ハゼ科
レッドモルウォン	タカノハダイ科
レッドライトゴビー	ハゼ科
レッドリップブレニー	イソギンポ科
レティキュレイトボックスフィッシュ	ハコフグ科
レモンコーラルゴビー	ハゼ科
レモンスズメダイ	スズメダイ科
レモンチョウチョウウオ	チョウチョウウオ科
レモンブダイ	ブダイ科
レンテンヤッコ	キンチャクダイ科
ロービングコーラルグルーパー	ハタ科
ローブスキンパファー	フグ科
ローランドダムゼル	スズメダイ科
ローレンツスズメダイ	スズメダイ科
ロイヤルデムワーゼル	スズメダイ科
ロイヤルドティーバック	メギス科
ロウニンアジ	アジ科
ロクセンスズメダイ	スズメダイ科
ロクセンフエダイ	フエダイ科
ロクセンヤッコ	キンチャクダイ科
ロックケール	アプロダクテュルス科
ロックビューティ	キンチャクダイ科
ロングジョースクォーラルフィッシュ	イットウダイ科
ロングスナウトバタフライフィッシュ	チョウチョウウオ科
ロングスノートシーホース	ヨウジウオ科
ロングスパインスクォーラルフィッシュ	イットウダイ科
ロングテールファイルフィッシュ	カワハギ科
ロングノーズサージョンフィッシュ	ニザダイ科
ロングバーベルゴートフィッシュ	ヒメジ科
ロングフィンダムセルフィッシュ	スズメダイ科
ロングフィンハーフビーク	サヨリ科
ロングフィンフェアリーゴビー	ハゼ科
ロングレイドワーフゴビー	ハゼ科
ワイドバンデッドクリーナーゴビー	ハゼ科
ワイドバンドアネモネフィッシュ	スズメダイ科
ワカウツボ	ウツボ科
ワカヨウジ	ヨウジウオ科
ワキイシモチ	テンジクダイ科
ワニゴチ	コチ科
ワヌケトラギス	トラギス科
ワヌケヤッコ	キンチャクダイ科
ワモンフグ	フグ科
ワンストライブフュージラー	タカサゴ科
ワンスポットプラー	スズメダイ科